date,Negative factual tweets,Negative personal tweets,Positive factual tweets,Positive personal tweets,Neutral factual tweets,Neutral personal tweets,Total amount of tweets
2019-10-01,7,3,13,25,24,0,72
2019-10-02,4,1,26,20,26,2,79
2019-10-03,9,3,29,31,52,1,125
2019-10-04,3,1,21,24,44,6,99
2019-10-05,1,5,12,27,23,3,71
2019-10-06,7,8,16,19,24,1,75
2019-10-07,6,4,28,27,38,2,105
2019-10-08,4,1,20,21,35,0,81
2019-10-09,6,5,20,18,23,1,73
2019-10-10,3,10,24,33,26,2,98
2019-10-11,4,6,25,17,29,5,86
2019-10-12,9,4,10,21,44,0,88
2019-10-13,3,4,17,19,22,1,66
2019-10-14,17,4,32,29,52,0,134
2019-10-15,41,4,35,38,78,4,200
2019-10-16,31,3,25,32,39,7,137
2019-10-17,32,3,29,34,38,5,141
2019-10-18,12,0,22,31,26,4,95
2019-10-19,3,5,16,19,42,3,88
2019-10-20,6,1,20,18,27,1,73
2019-10-21,7,0,21,20,48,1,97
2019-10-22,4,3,25,29,44,5,110
2019-10-23,5,2,26,15,41,2,91
2019-10-24,5,3,23,29,27,2,89
2019-10-25,6,1,41,33,36,4,121
2019-10-26,1,3,15,22,23,1,65
2019-10-27,3,2,28,34,30,1,98
2019-10-28,9,4,29,24,31,2,99
2019-10-29,9,5,17,36,36,5,108
2019-10-30,9,2,27,24,39,1,102
2019-10-31,6,4,28,37,29,1,105
2019-11-01,18,5,25,35,36,5,124
2019-11-02,33,4,61,51,192,9,350
2019-11-03,19,5,47,32,102,3,208
2019-11-04,14,8,37,37,90,3,189
2019-11-05,6,9,32,38,48,1,134
2019-11-06,8,1,32,32,55,1,129
2019-11-07,9,5,21,37,42,1,115
2019-11-08,4,4,28,31,35,3,105
2019-11-09,9,3,24,21,39,2,98
2019-11-10,3,3,17,19,19,7,68
2019-11-11,7,1,26,24,34,1,93
2019-11-12,6,2,30,28,33,0,99
2019-11-13,9,2,24,21,37,0,93
2019-11-14,8,4,53,38,42,2,147
2019-11-15,11,8,68,50,103,1,241
2019-11-16,1,3,28,22,40,3,97
2019-11-17,4,3,21,23,21,1,73
2019-11-18,9,5,26,26,32,4,102
2019-11-19,6,3,25,18,43,3,98
2019-11-20,9,1,18,32,22,3,85
2019-11-21,10,4,33,21,34,0,102
2019-11-22,2,6,22,22,27,1,80
2019-11-23,4,2,12,23,25,3,69
2019-11-24,3,3,17,21,24,2,70
2019-11-25,5,2,23,19,32,0,81
2019-11-26,8,2,28,24,27,2,91
2019-11-27,3,0,19,29,33,1,85
2019-11-28,4,2,17,31,24,0,78
2019-11-29,15,3,15,40,34,2,109
2019-11-30,9,1,11,22,21,2,66
2019-12-01,2,0,19,16,21,1,59
2019-12-02,8,4,30,27,32,0,101
2019-12-03,10,5,24,27,43,1,110
2019-12-04,4,2,20,29,40,7,102
2019-12-05,10,2,27,47,50,9,145
2019-12-06,5,2,32,29,51,3,122
2019-12-07,5,3,14,20,27,4,73
2019-12-08,2,5,23,21,24,0,75
2019-12-09,9,5,25,22,31,4,96
2019-12-10,4,5,35,32,37,0,113
2019-12-11,11,3,38,26,62,1,141
2019-12-12,10,4,33,45,36,3,131
2019-12-13,6,2,31,38,34,5,116
2019-12-14,4,3,26,31,33,2,99
2019-12-15,3,1,23,20,23,0,70
2019-12-16,4,2,19,19,34,0,78
2019-12-17,3,4,29,21,44,1,102
2019-12-18,7,3,20,38,37,3,108
2019-12-19,2,4,23,23,28,0,80
2019-12-20,6,4,19,33,27,0,89
2019-12-21,3,3,17,24,18,3,68
2019-12-22,5,3,20,24,30,0,82
2019-12-23,8,5,14,28,46,1,102
2019-12-24,1,2,29,36,37,1,106
2019-12-25,5,1,16,26,22,2,72
2019-12-26,4,4,15,25,22,4,74
2019-12-27,4,4,24,29,23,4,88
2019-12-28,4,2,27,25,17,1,76
2019-12-29,4,4,19,36,19,2,84
2019-12-30,11,6,14,49,34,2,116
2019-12-31,8,4,24,34,30,1,101
2020-01-01,11,6,24,32,23,0,96
2020-01-02,8,1,22,22,21,1,75
2020-01-03,12,1,21,26,24,3,87
2020-01-04,4,2,19,17,22,2,66
2020-01-05,6,4,21,17,17,4,69
2020-01-06,9,3,23,20,34,5,94
2020-01-07,10,4,28,34,43,1,120
2020-01-08,4,5,25,37,43,2,116
2020-01-09,4,3,21,21,28,0,77
2020-01-10,6,2,17,20,34,1,80
2020-01-11,3,1,23,19,27,2,75
2020-01-12,5,5,9,21,27,0,67
2020-01-13,6,6,19,17,34,0,82
2020-01-14,4,5,27,26,41,2,105
2020-01-15,10,5,28,19,23,2,87
2020-01-16,9,2,26,23,17,10,87
2020-01-17,10,2,18,24,30,2,86
2020-01-18,6,0,21,24,19,0,70
2020-01-19,3,2,18,39,22,1,85
2020-01-20,4,2,24,24,25,1,80
2020-01-21,6,7,29,29,29,2,102
2020-01-22,6,1,35,25,30,2,99
2020-01-23,3,3,29,33,27,0,95
2020-01-24,3,8,19,39,26,4,99
2020-01-25,6,21,14,31,36,1,109
2020-01-26,3,18,20,20,20,1,82
2020-01-27,11,17,23,24,38,8,121
2020-01-28,6,10,29,46,36,5,132
2020-01-29,27,12,59,88,217,7,410
2020-01-30,11,10,45,60,101,6,233
2020-01-31,7,2,42,27,35,2,115
2020-02-01,8,4,26,40,32,2,112
2020-02-02,8,4,23,29,20,2,86
2020-02-03,4,4,16,32,38,2,96
2020-02-04,5,2,21,27,48,1,104
2020-02-05,4,0,22,22,45,1,94
2020-02-06,4,2,28,37,41,28,140
2020-02-07,11,3,25,25,44,9,117
2020-02-08,9,4,12,26,25,2,78
2020-02-09,8,5,20,28,27,0,88
2020-02-10,7,2,22,24,34,1,90
2020-02-11,11,3,21,27,56,2,120
2020-02-12,5,8,29,44,67,6,159
2020-02-13,9,11,30,33,79,3,165
2020-02-14,6,5,46,52,65,3,177
2020-02-15,4,4,38,50,81,2,179
2020-02-16,4,4,23,49,51,4,135
2020-02-17,5,4,27,33,71,0,140
2020-02-18,10,5,41,47,56,2,161
2020-02-19,11,7,46,67,55,0,186
2020-02-20,11,13,48,41,43,1,157
2020-02-21,10,9,44,40,87,4,194
2020-02-22,44,12,82,121,252,15,526
2020-02-23,25,11,77,77,144,12,346
2020-02-24,23,17,72,134,120,7,373
2020-02-25,12,10,50,96,105,3,276
2020-02-26,9,6,46,59,91,4,215
2020-02-27,8,11,36,43,60,3,161
2020-02-28,15,11,48,46,48,3,171
2020-02-29,12,2,30,34,30,4,112
2020-03-01,7,2,22,35,24,4,94
2020-03-02,11,1,36,36,39,1,124
2020-03-03,24,7,32,61,74,1,199
2020-03-04,14,8,23,50,76,0,171
2020-03-05,13,3,49,47,66,0,178
2020-03-06,12,18,48,45,86,0,209
2020-03-07,15,5,26,56,51,1,154
2020-03-08,10,2,21,32,34,1,100
2020-03-09,11,6,41,53,49,5,165
2020-03-10,11,5,31,42,48,0,137
2020-03-11,11,2,39,51,90,3,196
2020-03-12,51,6,48,43,91,4,243
2020-03-13,233,14,93,134,170,4,648
2020-03-14,224,12,117,71,235,4,663
2020-03-15,40,7,46,30,75,0,198
2020-03-16,47,7,48,39,61,0,202
2020-03-17,28,6,42,68,57,3,204
2020-03-18,22,6,39,35,84,3,189
2020-03-19,15,5,31,39,51,2,143
2020-03-20,12,8,31,32,65,3,151
2020-03-21,17,5,26,39,33,0,120
2020-03-22,4,3,25,26,15,0,73
2020-03-23,21,4,31,30,55,1,142
2020-03-24,9,7,30,33,47,2,128
2020-03-25,3,6,35,36,51,3,134
2020-03-26,10,1,30,32,42,2,117
2020-03-27,13,4,24,32,28,3,104
2020-03-28,6,4,35,19,91,3,158
2020-03-29,6,4,22,23,64,2,121
2020-03-30,2,4,21,26,54,3,110
2020-03-31,3,1,27,33,53,3,120
2020-04-01,9,4,35,33,42,3,126
2020-04-02,6,8,78,31,31,0,154
2020-04-03,6,6,38,38,56,1,145
2020-04-04,23,21,83,88,177,3,395
2020-04-05,9,2,35,35,56,2,139
2020-04-06,12,8,51,48,113,4,236
2020-04-07,6,12,42,49,65,1,175
2020-04-08,18,4,31,32,52,2,139
2020-04-09,17,2,24,42,56,0,141
2020-04-10,11,6,63,36,39,1,156
2020-04-11,11,3,35,25,30,2,106
2020-04-12,10,2,26,36,31,2,107
2020-04-13,6,7,27,36,30,0,106
2020-04-14,8,2,31,26,47,0,114
2020-04-15,5,4,29,38,58,1,135
2020-04-16,5,2,38,39,48,3,135
2020-04-17,7,8,68,39,89,1,212
2020-04-18,5,3,17,32,98,4,159
2020-04-19,1,3,14,25,63,2,108
2020-04-20,13,4,34,44,80,2,177
2020-04-21,3,4,23,28,68,0,126
2020-04-22,6,7,30,37,47,0,127
2020-04-23,5,3,32,40,51,2,133
2020-04-24,12,4,21,31,47,0,115
2020-04-25,10,4,29,27,45,0,115
2020-04-26,2,3,22,30,29,1,87
2020-04-27,11,11,47,41,70,2,182
2020-04-28,15,7,47,47,70,6,192
2020-04-29,4,2,25,39,55,9,134
2020-04-30,11,9,38,48,79,35,220
2020-05-01,10,7,75,55,95,10,252
2020-05-02,81,52,632,366,541,12,1684
2020-05-03,278,90,442,358,982,91,2241
2020-05-04,69,51,206,218,311,43,898
2020-05-05,27,17,123,95,140,10,412
2020-05-06,12,10,71,63,104,11,271
2020-05-07,20,12,51,60,54,15,212
2020-05-08,25,5,40,54,48,3,175
2020-05-09,11,5,45,43,54,9,167
2020-05-10,5,2,32,49,37,1,126
2020-05-11,14,5,43,50,53,5,170
2020-05-12,7,7,42,51,43,17,167
2020-05-13,31,7,55,34,46,7,180
2020-05-14,19,4,58,60,69,6,216
2020-05-15,12,6,61,48,80,0,207
2020-05-16,24,13,63,72,110,5,287
2020-05-17,14,3,48,46,102,4,217
2020-05-18,16,4,45,68,81,2,216
2020-05-19,9,8,48,47,64,3,179
2020-05-20,12,16,27,38,46,4,143
2020-05-21,7,6,40,40,45,1,139
2020-05-22,8,5,36,41,29,4,123
2020-05-23,10,6,27,31,28,1,103
2020-05-24,8,2,26,24,33,1,94
2020-05-25,5,6,22,23,45,4,105
2020-05-26,7,4,33,38,57,0,139
2020-05-27,21,5,38,40,86,1,191
2020-05-28,14,8,29,32,132,1,216
2020-05-29,3,6,33,26,69,1,138
2020-05-30,8,4,33,40,41,3,129
2020-05-31,5,3,24,44,21,1,98
2020-06-01,8,11,42,30,59,5,155
2020-06-02,18,12,68,62,187,8,355
2020-06-03,33,15,47,112,104,3,314
2020-06-04,19,19,37,69,79,3,226
2020-06-05,12,3,52,40,73,1,181
2020-06-06,7,9,31,44,59,0,150
2020-06-07,10,2,14,22,31,2,81
2020-06-08,7,4,31,36,46,3,127
2020-06-09,11,4,45,33,41,1,135
2020-06-10,7,4,30,29,50,0,120
2020-06-11,10,5,33,31,37,2,118
2020-06-12,5,4,37,26,41,2,115
2020-06-13,5,2,24,25,32,2,90
2020-06-14,4,1,18,24,32,1,80
2020-06-15,3,5,29,32,26,2,97
2020-06-16,11,1,35,40,32,0,119
2020-06-17,13,5,42,43,73,5,181
2020-06-18,12,1,39,34,38,0,124
2020-06-19,7,7,25,31,29,0,99
2020-06-20,1,4,18,37,31,4,95
2020-06-21,5,1,22,54,20,1,103
2020-06-22,4,1,22,41,39,2,109
2020-06-23,5,1,36,46,39,1,128
2020-06-24,7,14,42,33,43,2,141
2020-06-25,5,5,40,42,53,3,148
2020-06-26,8,8,50,23,35,2,126
2020-06-27,6,5,22,19,25,0,77
2020-06-28,6,3,25,19,18,15,86
2020-06-29,39,8,73,26,46,6,198
2020-06-30,18,7,54,38,52,0,169
2020-07-01,4,11,43,30,63,5,156
2020-07-02,12,5,46,38,87,4,192
2020-07-03,7,5,36,39,56,0,143
2020-07-04,8,3,17,39,25,0,92
2020-07-05,11,5,82,39,91,2,230
2020-07-06,39,18,198,101,215,4,575
2020-07-07,21,5,95,49,96,38,304
2020-07-08,124,3,66,63,101,7,364
2020-07-09,32,7,80,38,75,10,242
2020-07-10,14,8,52,41,67,36,218
2020-07-11,14,10,61,32,54,13,184
2020-07-12,2,5,25,30,37,7,106
2020-07-13,12,12,55,32,44,4,159
2020-07-14,8,7,47,37,47,4,150
2020-07-15,6,5,47,41,67,2,168
2020-07-16,7,3,47,42,63,6,168
2020-07-17,12,10,35,42,65,2,166
2020-07-18,11,8,28,34,45,9,135
2020-07-19,7,8,32,34,30,4,115
2020-07-20,6,3,42,42,36,4,133
2020-07-21,17,4,62,33,47,3,166
2020-07-22,11,6,45,27,54,2,145
2020-07-23,13,6,46,35,72,7,179
2020-07-24,3,2,32,43,59,5,144
2020-07-25,9,5,16,40,38,2,110
2020-07-26,3,2,41,19,28,0,93
2020-07-27,7,7,37,25,45,3,124
2020-07-28,6,4,50,38,54,5,157
2020-07-29,5,6,38,34,67,0,150
2020-07-30,7,2,34,31,57,0,131
2020-07-31,11,13,37,54,83,0,198
2020-08-01,11,5,28,42,34,2,122
2020-08-02,7,4,21,29,32,4,97
2020-08-03,13,4,38,36,53,5,149
2020-08-04,9,6,41,31,80,2,169
2020-08-05,7,5,52,56,89,3,212
2020-08-06,8,4,64,47,61,3,187
2020-08-07,6,1,56,38,75,1,177
2020-08-08,26,6,109,68,315,4,528
2020-08-09,22,3,65,41,187,1,319
2020-08-10,15,10,70,53,136,14,298
2020-08-11,24,4,69,49,92,7,245
2020-08-12,6,7,30,43,47,0,133
2020-08-13,6,5,37,43,62,2,155
2020-08-14,17,21,46,45,120,6,255
2020-08-15,53,15,105,75,272,5,525
2020-08-16,10,10,59,43,95,4,221
2020-08-17,20,14,77,77,149,4,341
2020-08-18,24,3,58,87,111,8,291
2020-08-19,45,2,68,53,79,5,252
2020-08-20,16,2,41,47,73,6,185
2020-08-21,10,7,68,48,43,3,179
2020-08-22,9,2,39,33,37,1,121
2020-08-23,5,4,37,36,37,10,129
2020-08-24,6,2,54,48,46,2,158
2020-08-25,9,4,35,41,49,1,139
2020-08-26,4,2,40,24,53,2,125
2020-08-27,10,3,37,35,45,2,132
2020-08-28,12,3,48,40,47,1,151
2020-08-29,8,4,32,32,40,1,117
2020-08-30,6,4,36,54,47,1,148
2020-08-31,22,7,170,79,580,4,862
2020-09-01,11,5,63,61,83,2,225
2020-09-02,10,4,57,43,82,3,199
2020-09-03,9,6,49,40,51,1,156
2020-09-04,8,14,43,31,51,3,150
2020-09-05,7,39,33,54,74,10,217
2020-09-06,5,6,23,21,43,2,100
2020-09-07,7,6,34,38,46,2,133
2020-09-08,9,7,65,43,95,4,223
2020-09-09,13,15,112,48,136,6,330
2020-09-10,14,10,64,55,69,2,214
2020-09-11,16,8,41,37,57,4,163
2020-09-12,14,1,30,38,31,0,114
2020-09-13,8,6,33,21,43,1,112
2020-09-14,5,2,30,26,37,2,102
2020-09-15,12,6,44,33,44,0,139
2020-09-16,9,7,53,100,51,5,225
2020-09-17,7,7,65,65,39,1,184
2020-09-18,6,3,34,25,43,6,117
2020-09-19,5,0,45,24,22,2,98
2020-09-20,7,2,22,19,18,2,70
2020-09-21,13,15,55,17,32,2,134
2020-09-22,18,11,34,26,50,0,139
2020-09-23,3,5,41,44,50,1,144
2020-09-24,4,3,43,43,91,0,184
2020-09-25,7,5,45,37,66,3,163
2020-09-26,8,2,30,22,37,1,100
2020-09-27,6,3,20,19,27,1,76
2020-09-28,9,5,23,33,67,0,137
2020-09-29,23,12,49,46,53,0,183
2020-09-30,18,13,30,41,53,2,157
