date,Negative factual tweets,Negative personal tweets,Positive factual tweets,Positive personal tweets,Neutral factual tweets,Neutral personal tweets,Total amount of tweets
2017-10-01,1,0,4,2,20,4,31
2017-10-02,3,0,11,3,37,1,55
2017-10-03,29,1,113,36,451,1,631
2017-10-04,1,2,33,29,108,0,173
2017-10-05,2,1,16,11,66,1,97
2017-10-06,6,1,20,8,42,1,78
2017-10-07,0,0,6,5,69,0,80
2017-10-08,0,0,5,3,21,0,29
2017-10-09,5,0,24,12,19,1,61
2017-10-10,7,0,9,9,45,0,70
2017-10-11,9,0,12,13,40,4,78
2017-10-12,4,0,20,8,54,4,90
2017-10-13,2,0,17,7,33,2,61
2017-10-14,2,0,18,11,43,6,80
2017-10-15,3,1,15,3,15,3,40
2017-10-16,18,0,14,8,27,0,67
2017-10-17,6,0,20,4,39,1,70
2017-10-18,5,2,22,9,14,0,52
2017-10-19,4,1,17,13,46,3,84
2017-10-20,13,0,22,8,49,2,94
2017-10-21,4,1,13,7,41,0,66
2017-10-22,2,0,8,23,24,0,57
2017-10-23,8,0,13,8,39,1,69
2017-10-24,4,1,19,10,32,2,68
2017-10-25,6,3,12,11,28,1,61
2017-10-26,3,4,17,11,34,6,75
2017-10-27,5,2,29,9,35,4,84
2017-10-28,3,0,7,6,22,2,40
2017-10-29,3,1,4,4,29,0,41
2017-10-30,2,0,13,7,26,0,48
2017-10-31,4,2,10,11,41,3,71
2017-11-01,5,2,26,12,39,3,87
2017-11-02,7,1,29,14,33,3,87
2017-11-03,30,3,39,14,159,4,249
2017-11-04,3,1,24,3,67,4,102
2017-11-05,0,1,10,4,49,5,69
2017-11-06,12,3,8,8,58,3,92
2017-11-07,6,2,33,12,53,1,107
2017-11-08,4,1,32,13,60,0,110
2017-11-09,9,4,28,9,40,5,95
2017-11-10,2,0,20,13,42,1,78
2017-11-11,4,0,5,16,25,2,52
2017-11-12,5,0,5,16,30,0,56
2017-11-13,5,0,13,28,56,0,102
2017-11-14,4,0,38,17,188,1,248
2017-11-15,9,0,62,15,145,2,233
2017-11-16,3,1,18,21,45,0,88
2017-11-17,3,4,29,19,46,3,104
2017-11-18,2,2,52,7,29,7,99
2017-11-19,6,5,15,8,29,2,65
2017-11-20,2,1,11,21,42,3,80
2017-11-21,2,2,24,30,54,1,113
2017-11-22,9,2,15,12,65,1,104
2017-11-23,4,1,4,9,29,0,47
2017-11-24,3,0,10,11,20,0,44
2017-11-25,5,0,9,9,39,0,62
2017-11-26,1,3,8,4,34,0,50
2017-11-27,2,1,5,8,42,1,59
2017-11-28,4,2,24,14,40,2,86
2017-11-29,3,2,18,17,72,1,113
2017-11-30,2,0,18,20,57,0,97
2017-12-01,10,0,25,9,65,1,110
2017-12-02,3,0,16,14,30,1,64
2017-12-03,1,1,12,10,29,1,54
2017-12-04,1,1,25,11,39,5,82
2017-12-05,3,5,10,16,54,0,88
2017-12-06,4,0,25,11,54,2,96
2017-12-07,7,1,16,34,58,2,118
2017-12-08,1,2,17,8,67,4,99
2017-12-09,8,1,13,6,24,1,53
2017-12-10,1,0,15,1,21,3,41
2017-12-11,8,0,23,7,29,2,69
2017-12-12,1,1,50,21,52,4,129
2017-12-13,0,1,101,13,54,0,169
2017-12-14,2,3,63,17,43,2,130
2017-12-15,2,1,22,21,48,4,98
2017-12-16,0,1,12,9,62,2,86
2017-12-17,8,0,10,7,26,0,51
2017-12-18,2,0,135,68,96,0,301
2017-12-19,6,2,100,61,102,1,272
2017-12-20,6,3,40,30,64,1,144
2017-12-21,7,2,27,18,56,3,113
2017-12-22,4,1,37,9,40,0,91
2017-12-23,1,0,10,6,27,0,44
2017-12-24,1,1,12,32,27,0,73
2017-12-25,0,0,10,12,27,0,49
2017-12-26,2,1,11,6,42,3,65
2017-12-27,3,3,15,10,32,0,63
2017-12-28,2,1,15,19,66,2,105
2017-12-29,2,2,27,11,44,1,87
2017-12-30,1,0,11,16,27,2,57
2017-12-31,1,0,9,6,36,0,52
2018-01-01,1,0,6,6,25,2,40
2018-01-02,2,4,20,13,37,1,77
2018-01-03,2,2,15,20,33,0,72
2018-01-04,2,1,12,14,29,0,58
2018-01-05,4,0,21,13,33,2,73
2018-01-06,15,1,9,12,23,1,61
2018-01-07,2,0,7,6,25,1,41
2018-01-08,4,3,27,10,84,0,128
2018-01-09,7,2,22,11,91,0,133
2018-01-10,19,31,93,70,342,60,615
2018-01-11,30,22,28,60,186,21,347
2018-01-12,3,5,35,42,64,7,156
2018-01-13,5,0,18,24,64,2,113
2018-01-14,6,3,9,4,46,2,70
2018-01-15,5,0,15,9,49,2,80
2018-01-16,3,4,14,14,44,1,80
2018-01-17,3,2,20,13,57,2,97
2018-01-18,3,5,21,18,47,1,95
2018-01-19,10,16,19,35,61,5,146
2018-01-20,4,4,20,18,32,2,80
2018-01-21,9,4,14,6,31,0,64
2018-01-22,1,1,35,7,39,0,83
2018-01-23,5,0,22,18,58,2,105
2018-01-24,6,2,19,26,55,2,110
2018-01-25,4,2,14,14,49,2,85
2018-01-26,1,0,15,16,32,3,67
2018-01-27,3,1,22,9,45,3,83
2018-01-28,1,1,7,4,35,0,48
2018-01-29,5,2,20,14,34,1,76
2018-01-30,230,177,1507,1414,4639,83,8050
2018-01-31,112,74,452,407,1458,25,2528
2018-02-01,38,24,160,117,488,15,842
2018-02-02,40,15,73,58,201,7,394
2018-02-03,36,7,56,27,112,3,241
2018-02-04,4,4,28,32,101,3,172
2018-02-05,16,12,60,32,136,8,264
2018-02-06,29,16,44,39,130,2,260
2018-02-07,14,44,46,39,92,6,241
2018-02-08,6,8,54,31,162,3,264
2018-02-09,7,33,43,24,89,8,204
2018-02-10,1,11,30,14,68,4,128
2018-02-11,2,8,18,12,35,5,80
2018-02-12,5,5,44,17,94,1,166
2018-02-13,5,5,62,34,94,2,202
2018-02-14,53,2,95,81,217,5,453
2018-02-15,101,175,105,108,303,10,802
2018-02-16,19,178,54,39,124,10,424
2018-02-17,11,19,29,16,55,4,134
2018-02-18,6,7,21,10,58,1,103
2018-02-19,13,5,32,73,65,6,194
2018-02-20,9,16,71,35,57,7,195
2018-02-21,6,24,39,26,76,2,173
2018-02-22,11,11,46,40,79,1,188
2018-02-23,6,6,31,37,78,10,168
2018-02-24,44,30,219,145,927,19,1384
2018-02-25,25,17,150,87,400,9,688
2018-02-26,54,24,184,353,284,20,919
2018-02-27,39,23,79,80,167,9,397
2018-02-28,15,10,51,88,102,1,267
2018-03-01,9,7,43,70,78,2,209
2018-03-02,15,3,49,24,55,3,149
2018-03-03,6,6,16,27,59,5,119
2018-03-04,10,5,24,25,65,2,131
2018-03-05,4,8,83,34,110,1,240
2018-03-06,13,1,51,36,80,4,185
2018-03-07,13,7,44,15,63,7,149
2018-03-08,10,3,49,28,64,2,156
2018-03-09,6,2,43,16,74,7,148
2018-03-10,9,6,54,17,68,2,156
2018-03-11,4,6,17,18,50,1,96
2018-03-12,8,1,34,40,56,2,141
2018-03-13,6,4,33,40,77,2,162
2018-03-14,8,5,26,16,40,0,95
2018-03-15,11,4,26,24,61,4,130
2018-03-16,11,8,24,27,47,7,124
2018-03-17,18,1,23,23,47,0,112
2018-03-18,2,0,23,11,43,1,80
2018-03-19,5,2,24,23,40,0,94
2018-03-20,7,2,29,65,82,7,192
2018-03-21,4,2,29,33,41,2,111
2018-03-22,5,0,33,26,42,1,107
2018-03-23,7,1,20,23,37,5,93
2018-03-24,4,1,13,11,41,4,74
2018-03-25,2,1,19,10,40,2,74
2018-03-26,7,6,34,22,51,2,122
2018-03-27,8,3,36,16,64,1,128
2018-03-28,4,3,29,25,63,7,131
2018-03-29,4,2,29,24,54,1,114
2018-03-30,3,0,40,26,48,2,119
2018-03-31,6,4,19,7,40,2,78
2018-04-01,3,3,26,8,44,4,88
2018-04-02,5,2,22,21,50,5,105
2018-04-03,9,3,38,35,75,4,164
2018-04-04,10,2,27,27,65,1,132
2018-04-05,22,2,59,36,60,4,183
2018-04-06,7,3,46,26,61,5,148
2018-04-07,9,2,31,23,53,2,120
2018-04-08,5,2,22,13,66,3,111
2018-04-09,11,0,36,27,55,4,133
2018-04-10,7,4,27,60,85,1,184
2018-04-11,9,3,25,31,55,2,125
2018-04-12,10,3,28,31,77,1,150
2018-04-13,11,3,24,37,69,4,148
2018-04-14,3,1,29,19,51,3,106
2018-04-15,1,1,27,25,34,0,88
2018-04-16,6,2,21,27,54,3,113
2018-04-17,10,4,40,38,106,1,199
2018-04-18,8,2,30,36,63,2,141
2018-04-19,8,6,36,35,71,3,159
2018-04-20,5,2,33,32,59,7,138
2018-04-21,5,0,38,24,51,2,120
2018-04-22,5,1,15,22,47,2,92
2018-04-23,7,3,28,30,59,3,130
2018-04-24,7,0,35,47,89,0,178
2018-04-25,57,6,32,35,68,3,201
2018-04-26,17,5,39,49,69,2,181
2018-04-27,19,1,30,48,63,4,165
2018-04-28,7,6,24,31,53,6,127
2018-04-29,9,1,25,24,66,1,126
2018-04-30,8,4,52,35,54,4,157
2018-05-01,4,0,39,52,125,4,224
2018-05-02,11,3,57,34,99,3,207
2018-05-03,10,11,139,64,144,6,374
2018-05-04,34,16,479,585,504,73,1691
2018-05-05,94,118,378,597,821,24,2032
2018-05-06,104,47,153,169,333,22,828
2018-05-07,65,72,215,235,488,18,1093
2018-05-08,36,30,175,106,256,17,620
2018-05-09,22,14,74,58,134,6,308
2018-05-10,21,8,61,52,123,2,267
2018-05-11,15,9,40,69,85,10,228
2018-05-12,4,7,50,38,95,11,205
2018-05-13,7,5,22,33,58,3,128
2018-05-14,8,2,44,33,64,1,152
2018-05-15,12,3,72,65,125,2,279
2018-05-16,10,5,83,75,206,5,384
2018-05-17,10,8,39,49,94,2,202
2018-05-18,10,9,44,37,87,16,203
2018-05-19,16,3,31,20,63,1,134
2018-05-20,2,4,24,14,55,4,103
2018-05-21,4,4,46,35,67,2,158
2018-05-22,8,6,52,58,95,3,222
2018-05-23,3,3,36,40,61,2,145
2018-05-24,14,2,44,39,96,6,201
2018-05-25,8,14,58,46,80,4,210
2018-05-26,6,8,26,21,55,2,118
2018-05-27,6,1,18,11,64,4,104
2018-05-28,1,3,12,28,60,1,105
2018-05-29,11,7,38,28,84,1,169
2018-05-30,5,2,44,44,80,9,184
2018-05-31,17,8,43,38,52,3,161
2018-06-01,10,17,55,34,58,4,178
2018-06-02,0,12,42,29,67,1,151
2018-06-03,5,2,21,31,56,2,117
2018-06-04,8,1,32,37,102,2,182
2018-06-05,12,3,45,48,84,4,196
2018-06-06,6,1,40,35,65,4,151
2018-06-07,15,9,47,49,100,8,228
2018-06-08,6,7,35,47,73,11,179
2018-06-09,3,1,21,20,38,4,87
2018-06-10,5,2,20,14,51,6,98
2018-06-11,7,5,43,29,55,4,143
2018-06-12,15,4,44,32,73,7,175
2018-06-13,9,3,50,34,71,6,173
2018-06-14,10,1,85,34,65,9,204
2018-06-15,10,5,28,28,53,11,135
2018-06-16,4,4,26,30,57,1,122
2018-06-17,9,3,23,26,53,3,117
2018-06-18,5,4,30,29,72,1,141
2018-06-19,9,6,40,32,74,4,165
2018-06-20,27,49,254,169,469,7,975
2018-06-21,24,13,164,91,240,3,535
2018-06-22,12,6,65,60,93,5,241
2018-06-23,5,6,18,25,60,1,115
2018-06-24,5,7,22,23,68,5,130
2018-06-25,13,5,45,41,79,4,187
2018-06-26,13,8,57,58,188,7,331
2018-06-27,15,17,51,43,124,6,256
2018-06-28,28,17,46,30,84,8,213
2018-06-29,17,2,48,43,75,7,192
2018-06-30,6,1,30,19,45,3,104
2018-07-01,12,2,29,15,49,3,110
2018-07-02,12,8,24,38,54,0,136
2018-07-03,9,5,43,50,71,2,180
2018-07-04,4,5,16,33,63,3,124
2018-07-05,7,1,26,23,42,1,100
2018-07-06,6,5,31,53,61,3,159
2018-07-07,4,1,31,31,54,3,124
2018-07-08,6,2,16,29,39,3,95
2018-07-09,5,1,47,37,60,2,152
2018-07-10,8,4,44,35,62,1,154
2018-07-11,7,3,55,39,60,3,167
2018-07-12,13,2,43,48,152,2,260
2018-07-13,8,5,43,40,148,7,251
2018-07-14,5,1,23,28,55,2,114
2018-07-15,5,1,16,44,26,4,96
2018-07-16,9,0,34,40,66,1,150
2018-07-17,15,2,50,62,109,2,240
2018-07-18,15,6,77,86,272,9,465
2018-07-19,12,7,54,46,130,1,250
2018-07-20,13,11,43,45,61,3,176
2018-07-21,6,1,27,20,56,4,114
2018-07-22,3,5,21,16,41,1,87
2018-07-23,6,3,23,39,58,2,131
2018-07-24,4,0,44,43,81,29,201
2018-07-25,11,2,32,41,66,26,178
2018-07-26,14,1,69,38,59,5,186
2018-07-27,12,1,53,40,56,8,170
2018-07-28,6,1,34,35,47,8,131
2018-07-29,6,3,23,12,32,6,82
2018-07-30,8,3,20,29,48,2,110
2018-07-31,7,1,42,48,66,1,165
2018-08-01,12,4,44,30,97,1,188
2018-08-02,13,5,40,41,84,4,187
2018-08-03,16,3,48,55,99,6,227
2018-08-04,49,3,76,37,372,6,543
2018-08-05,21,0,95,33,135,1,285
2018-08-06,51,2,87,74,279,10,503
2018-08-07,16,6,101,63,138,5,329
2018-08-08,17,7,44,58,108,3,237
2018-08-09,10,8,29,54,77,4,182
2018-08-10,12,7,40,45,68,19,191
2018-08-11,7,0,32,24,57,4,124
2018-08-12,5,0,13,17,53,3,91
2018-08-13,13,5,27,27,61,2,135
2018-08-14,15,4,51,69,150,7,296
2018-08-15,12,3,95,72,254,4,440
2018-08-16,7,3,46,51,77,1,185
2018-08-17,11,4,36,38,80,3,172
2018-08-18,4,0,18,25,61,1,109
2018-08-19,4,0,13,27,37,0,81
2018-08-20,8,5,25,37,49,5,129
2018-08-21,6,4,38,32,51,2,133
2018-08-22,8,4,30,31,48,3,124
2018-08-23,8,1,35,35,52,3,134
2018-08-24,7,1,33,38,77,2,158
2018-08-25,5,3,28,33,36,4,109
2018-08-26,3,1,9,22,27,0,62
2018-08-27,65,10,262,78,739,6,1160
2018-08-28,61,17,103,86,406,14,687
2018-08-29,14,2,50,49,185,11,311
2018-08-30,34,6,55,74,107,6,282
2018-08-31,18,9,55,54,66,4,206
2018-09-01,8,3,29,27,41,2,110
2018-09-02,19,5,15,39,46,4,128
2018-09-03,21,3,18,55,60,3,160
2018-09-04,21,1,60,38,85,2,207
2018-09-05,9,5,33,52,69,1,169
2018-09-06,14,6,34,43,81,0,178
2018-09-07,10,4,44,56,79,3,196
2018-09-08,3,7,29,30,34,1,104
2018-09-09,5,0,39,23,38,3,108
2018-09-10,11,7,31,39,62,3,153
2018-09-11,9,6,33,59,92,1,200
2018-09-12,14,4,37,58,71,3,187
2018-09-13,6,1,33,36,69,7,152
2018-09-14,3,5,51,52,57,5,173
2018-09-15,3,3,22,35,38,1,102
2018-09-16,4,0,24,25,32,1,86
2018-09-17,9,8,39,32,38,2,128
2018-09-18,8,5,46,32,51,17,159
2018-09-19,17,8,61,55,26,8,175
2018-09-20,7,3,54,53,61,4,182
2018-09-21,22,2,74,33,42,4,177
2018-09-22,6,3,49,32,33,5,128
2018-09-23,4,1,23,22,36,3,89
2018-09-24,8,2,38,28,38,5,119
2018-09-25,8,9,47,54,47,2,167
2018-09-26,40,4,56,94,56,3,253
2018-09-27,17,3,81,55,83,6,245
2018-09-28,12,3,45,51,70,5,186
2018-09-29,6,2,27,28,37,2,102
2018-09-30,4,1,61,34,27,0,127
